0,1,0,3,0,0,0,2,0,20
1,11,1,3,1,10,1,2,1,21
0,1,3,11,1,0,3,10,1,20
0,10,0,3,0,11,0,2,0,23
0,1,2,10,2,0,2,11,2,20
5,11,5,3,5,10,5,2,5,25
10,1,10,11,10,0,10,10,10,30
13,10,13,3,13,11,13,2,13,33
11,1,11,10,11,0,11,11,11,31
14,1,14,3,14,10,14,2,14,34

